#############################################################
A.....#...#...#.......#.......#.........#.........#.....#...#
#.###.#.#.#.###.#####.#.#####.#.#####.#.###.#####.#####.###.#
#.#...#.#.#.........#...#...#.#.#.#...#.....#.........#...#.#
#.#####.#.###############.###.#.#.#.#########.###.###.###.#.#
#.......#.#.....#.......#.....#...#.#.....#...#...#.#...#...#
#########.#.###.#.#####.#.#######.#.#.#.###.#######.###.###.#
#...#...#.#.#...#.#.#...#.........#.#.#.#...#.......#...#...#
###.#.#.#.#.#.###.#.#.###.#########.#.###.###.#####.#.#####.#
#...#.#.#.#.#.#.#.#.....#...#.......#...#.....#.#...#.......#
#.###.#.#.###.#.#.###.#####.#.###.#####.#######.#.#####.#####
#...#.#.#.......#.#.#.#.....#...#.........#...#...#...#.....#
###.#.#.#####.#.#.#.#.#.#.#####.#########.#.#.#####.#######.#
#.#.#.#.......#...#.#...#.#.....#.........#.#.#...#.#.......#
#.#.#.#############.#####.#.#####.#########.#.###.#.#.###.#.#
#.#...#.....#.....#.#...#.#...#...#.........#...#.....#...#.#
#.#####.#.###.#####.#.###.#####.###.#.#########.###.#######.#
#...#...#...#.........#...#.....#...#...#.#...#.#.#...#.....#
#.#.#######.#######.###.#.#.###########.#.#.#.#.#.#####.#####
#.#...#...........#.....#.#.#.#.....#...#...#...#...#...#...#
#.###.#.#########.#########.#.#.###.#.#############.#.#####.#
#.#...#.#...#...#.......#...#.#.#.#.#.#.......#...#...#.#...#
#.#.###.#.#.#.#.#######.#.###.#.#.#.#.#.#####.#.#.###.#.#.###
#.#...#.#.#...#...#...#...#...#.#.#.#.......#.#.#.....#...#.#
#.###.#.#.#######.#.#.#####.#.#.#.#.#######.#.#.#######.###.#
#.#...#.#.......#.#.#.......#.#...#.#.....#.#.........#.....#
#.#.###.#########.#.###.#####.#####.#.###.#.###.#####.#.###.#
#.#...#.....#.......#.#...#.#...#.....#.#.....#.#.....#.#.#.#
#.###.#####.#.#######.###.#.###.#######.#####.#.#.#####.#.#.#
#.#...#...#.#...#...#.....#...#...#.#...#.#...#.#...#.#.#.#.#
#.#.###.#.#.###.###.#########.###.#.#.#.#.#.###.###.#.#.#.#.#
#.#.....#.#...#.....#.#.....#...#.#...#.#.#...#.#...#.#.#.#.#
#.###########.#.#####.#.###.###.#.###.#.#.###.#.#####.#.#.#.#
#.......#.....#.#...#.....#...#...#...#.#.#...#...#...#.#...#
#.#####.#.#####.#.#.#########.#########.#.#.#####.###.#.#####
#...#.....#...#.#.#.....#...#.............#.#...#...#...#...#
#.###.###.#.#.#.#.#####.#.#####.###########.#.#.#.#.#.#####.#
#...#...#.#.#...#...#...#...#.#.........#...#.#.#.#.........#
###.###.###.#######.#.#####.#.#########.#.###.#.#.###.#######
#.#...#.#.......#...#.#...#.#...#...#.#...#.#.#...#...#.#...#
#.###.#.#.#######.###.#.#.#.###.#.#.#.#####.#.#####.###.#.#.#
#.#.#.#.#.#.....#.#...#.#.#...#...#...#...#.......#.#...#.#.#
#.#.#.#.#.#.###.#.#.###.#####.#.#####.###.###.###.#.#.#.###.#
#.....#...#...#.#.#.......#...#.#...#...#.#.#.#...#...#.....#
#####.#########.#.#######.#.###.#.#.#.#.#.#.#.#.#######.#####
#.....#.....#...#.#.......#...#...#.#.#...#...#.#...#...#...#
#.#######.#.#.###.#.#########.#####.###########.#.#.###.#.#.#
#...#.#...#...#.#.#.#.#...#...#...#.#.....#.......#...#...#.#
###.#.#.###.###.#.#.#.#.#.#.###.#.#.#.###.#.#####.###.#####.#
#.....#.#...#...#.#.....#...#.#.#...#...#...#...#.#.....#.#.#
###.#.#.#.###.#.#.#.#########.#.#######.###.#.#.###.###.#.#.#
#...#...#...#.#...#.#...#...#.#...#...#...#.#.#.....#...#...#
#.#########.#.#####.#.#.#.#.#.###.###.#.#.###.#######.#####.#
#.#.........#.#.....#.#...#.#.....#...#.#...#.#.........#...#
#.#########.#.#####.#.#####.###.###.#######.#.#######.#.#.###
#.........#.#.....#.#...#.#.#...#.#.........#.#.......#.#...#
###.#######.#####.#.###.#.#.#.###.###########.#.#######.###.#
#.#.......#.#...#.#.#...#.#.#.#...#.......#...#.#.....#.#.#.#
#.#######.#.#.#.#.#.#.#.#.#.#.#.#.#.###.###.###.#.###.#.#.#.#
#.........#...#...#...#.#.......#.#...#.....#...#...#...#...B
#############################################################