##############################
#######....########....###...#
######..##..######..##..#..###
#####..####...###..####...####
#####.##.##.#..##.#######.####
#####.##.##.##.##.#######.####
####..##.##.##.##.#######.####
####.###.##.##.##.#######...##
####.###.##.##.##.#######.#.##
####.###.##.##.##.#######.#.##
####.###.##.##.##...#####.#.##
####.###.##.##.##.#..####.#.##
####.###.##.##.##.##.####.#.##
####.###.##.##.##.##.####.#.##
####.###.##.##.##.##.####.#.##
####.###.##.##.##.##.####.#..#
####.###.##.##.##.##.####.##.#
###..##..##.##.##.##.####.##.#
###.###.###.##.##.##.####.##.#
###.###.###.##.##.##.####.##.#
###.###.###.##..#.##.####.##.#
###.###.###.#####.##.####.##.#
###.###.###.##.##.##..###.####
###.###.###.##.##.###.###.##.#
###.###.###.##.##.###.###.##.#
###.###.###.##.##.###.###.##.#
###.###.###.##.##.###.###.##.#
###.##..###.##.##.###.###.##.#
###.#..####.##.##.###.###.##.#
###...#####.##.##.###.###.##.#
###.#######.##.##.#######.##.#
###.#######.#..##.###.###.##.#
###.#######...###.##..###.##.#
###.##....#.###.#.##.####.##.#
##..##.##.#.###.#.##.####.##.#
##.###.##.#.###.#.##.####.##.#
##.###.##.#.###.#.##.####.##.#
##.###.##.#.###.#.#..####.##.#
##.###.##.#.###.#.#.#####.#..#
##.###.##.#.###.#.#.#####...##
##.###.##.#.###.#.#.#####.####
##.###.##.#..#..#.#.#####.####
#..###.##.##...##.#.#####.####
#.##...##.##.####.#.#####.####
#....####.##.####...#####.####
#.#######.##.###..#######.####
#.#######..#.##.....#####.####
#.########.#.#..###...###..###
#.########.#...######...##..##
#A#########################B##